01100101101000001010100000011000101010011000010110000100001100100001000001000101000101000000010100010
01001010000000100000110001000100000101011011101010000111010010010100000110010010001010100010000011000
00001001000010100000110000000100011110011000010010100101001011110000100010000101001100000100110000010
11100000000001010010010000001000001001001000100000000000000011001101010011011000001011000010000101000
10000000100001000100010000011000100001011000010000100001100100000000011000001011000100111000011010100
11100001010000100000000000110000000000000111000100000100100100000000100001001000010110000010100000100
00110111001000000010000000000001000000001010110010100010001100010000100001000011111111101011010000110
01001101100010110011001100010000000010000110001101000100001001000101000000100000111100011000000100100
01110100011001010110010000000100101000100000100101000100010000010100000110101001010000000001111001101
00100001001100011000001010011000001000011010100010001000001000101000011011000010110101101100011100101
11100110000100110100000000100000101110000010100000000010101110001010100100000100110000000110000000010
00001011001100011010000110010000110101010100101000001011000100111001001001000000100110100010001010001
00000100101011000000001000000011000000001100000000000100001000000010000010000000000000100111000001010
00001100001000010000000000110100000100001100100001000110000000000000011000000000001100110011100100101
11001000100000010000001101001111000010000010110000001101100001010100011000010000000010010000010001100
00110111001110000000100001000000011010001101100000000000010000000100010100110100100000100101000001000
00000011101101010010010000010100000011011001010100100010100011101100000000110000100000010000000000001
10000111000010010000010000000000000000110000011010001101100001111100100001000100101010010001000010010
11000010000110101110000000000100010000001011000001000100000000011000011000100110000101011000011000001
01100100001000110000100100010000011100110010000000000010101100000011000010100100010000010110110110000
00010000100000000110101100011100010000000000000000100110001010000100000000100001100010010001010001010
00000110000001010101010000100000001010000000000001111000001010010000100100000010000011000001000110001
00100000001000011000100000001000001101100001010000000000000111000100010100010000000001100000000100010
00011000101000000001110110101000100000000001000001101000010101000010101000100000001100001010011100000
11011001000000000101001010000001000000000000000010000000001110010010001001000000101100011010000110010
10101000000100010010010000001100111011001000000000000000111000000100010010100000010100001011100010001
01001111000000001001111000000000010000001110001101000000000000000010000000010011001100001000001001000
00011100110010010001111001000010010010100000000110100110000001000000100010000001000100100000000001000
00000001100000010000000100000001100010000000000000101100100010110000100110100000000100001100000000000
00100010100100101000100001110101100010000010000110001001001100000110110100101010011101101110100100010
10001000000100001010001010010000000000100100010010100000000001010100101100000101010001000100000000100
01001110000000000000001010000000000011010010001100001100101000110101000101100000001000101001000000000
01101010101000000000010100000010010000000101000101110010000000001100000110110100000001001100000010100
10000000001000000001000010000100011110110111100000000100011000011001100100100111000010000010001000100
01000000000100000100000010110011010011000111000000101010011111000100001000010000010000000101111000000
01010101000010000000100101100011000010010010000000000001000000110010100000010000000010010001100101100
00000001100100111000010100010000100000010100001000000101000001011011110101010001110010110110000000001
00000000100100010100010010010100000001000000010100000100000001000001100100110011100010000000010000010
00001001100000010010011010100001000101100000110111000010000101100000100100001111111000110001000001010
00100000010000000101010010110000001000011100001101000100010000000010011010100100000100011100000100100
01010000000000111101001000000100101011000111000101100001101000110000110010000100001110001000110100010
10000000010100010011011110010000000000000100010001110001001000000001010010000010110001011000000001010
01010110000000011110100101001000001100010000100000010000000010010000001000100010110000000100011000100
01000100001010000010101001000000100000100000000000000011000010000010100100000000010001110000100000011
10000000011000001100000010001000000010001000111101000000001000100001001000100010000100010100110101100
00010001011001010010101010001000000001000101000001001111000000100000110001000000001100101001000001001
10000100000110100010100010000110001100000001000010010000000110100010010010000100000000100011001000000
10101000101001110011000100010000010000100010010011111001000011110100100001010100000000000001010101000
00000011000101100011001011001000000101110101000111000011000100001100100000000000100010000011010011010
11000011000100001101000100001000010000000111010000010101100001110000101100000000101000011001001000100
10100010110100100010010110100100100100010100110010100111000000000110011100101000000000001100101001011
00000001001101010101010100000110001110000100000111000001001001110000011001100000100000000100000000100
01001010010100010000000000000000000100000011001001100011100100001011000001010010011001001100000100010
10010000010010010010000010000101000100110000110110010010100100001011000000001100001101110001000000100
01010001100010010000000010010010001110100000010001001101001010000011000001011010001010000000100000100
00011000001110011100000000010101010010010000100000010110000000100000010101010101100001101000001001000
01001000100011000110010010111110000011000000001011001110001100000000010001000000000110010001100000101
11001000000101010000100000100011101000000111000001000000101010000000000000000010011001000110101001011
00001000110000001001001100000000001010010001010000101111101100000110010010011100100100001010000000011
00001000101110000101000011100111011000001010000000101000100100000000010000100000010001010110000011101
00000110001011000001100000110010001010000010000001000101000101110100111000000010100001000111110000100
00001001000100101110100100001100101010000010010000010110100110101000100000101100001000000000001001011
00000010110011000100001111110100100001010000111011010100011100011011010000001010000101000010100000111
00001011000100010010011100000101100000000000010000100000000001111000000010000000000100000000000101010
00011000001000101000000010000011010000100111100000111100101010001000001001101100101100000100101100101
00000010000000001010001110010000100100001000000100001000010000000101000000101110000000001000010101000
00101010100101000000000000010000100100000111010100100000110001000111001001000001100010010100100100000
00111000111011010101011000101000110000001100000100010001000011100011010000000100000000010010101000001
00101000000001110100000000010000011000001000011011010100000010111000110001100010010110000001000000111
10000000000000000100100100110000110000001000000010001000010001001001100010001100110101011001000000000
10010000100010011010001101100001000000000011100011000100000001000101010000001000000100000000001110000
01111100100000001001100001000000100010000101001000000011000000000011100000000110100001010001000011110
00101011000000010001000100100111010010100010000000010001000100000000011000100010010100000001101111010
10001000100000110010001100000100010010011000010000000001100100100101111000110000101101100000101011010
00010001010101110100000000110010111110011000000101000000010001100110001011000001011011110101100000100
01011000010100000101000010001100100001000000010000001100000101110110000001000000000110000101001101000
00001100010010010001000100011000100000110100011000000110001001000111100110001001010010100001000111000
00000011110001001000001001000010110000100001000100011010000010001001011100100100001010000100000000010
10000000010100110000000110000000000000000011100110000100101000000110100101010000000011000000001000001
11111010100101001100101101011010001010000110000111010001000011010101001011000000100000111111100010100
10100001100101000001000110010110000000010111111000000000010000010000000010100000100010100000100000000
01000001010000100001001000101010100000111100000100101001101010000000110000000000000000000001000000000
00010001000000001000100010010000111100101100111010100010000110101011010100010001100001100000000100000
10100010100011000000101100100001010001110001000000010100101010001000011000000011000000100000000010000
00001000101000000111010011000000011000100011111001011000000000010001101000010010011100000001000010101
11001010001000000010100001000011110001011110000001000001000000000010000010110011101101110010000000100
00001010101101101001100011100000000000000001011010100010001011010100100000010001010000000010110001000
00011101000001000000000100000100011000000000001100001100011010000001001101000000000100100000000001000
11000010010100010001000001100000110000010001010010100101000001000010000001001010000100010100110110011
10010101000100100100100011100010100110010101100010000101000010101110000000110110110010100000000001010
10000100000011000001010000000010000011000001100000100000000111101001011111001110101100000100000101100
10000000010110100000100010001110011001000010011000010100000001011001000010101000100000011000011010001
00100010000100000000100011000111111001000110000110001001010010000000110101000001110001001001111100001
01100000000000010001000010011101000000000101000010010000000000000001000001010001000000000110000000100
00001001000011000110000000000000100000100011011010100001110000100110110000001010001110100110100100110
11001110100100001000010001101100001100100000100001111011000101100100100000100001000111011100001000100
10010010100110110001011101110101100100100000000000101010001001100100000010000001110110011010001000011
01100000100000100000001000000010010100000000000010100000000001100101100011000011000010100000000111000
00101000100000011000001100100000000000100000000010100100000111000000110000110100000100010000101000000
00010100110000000101000000001000001000110110010010101001110010000100001000000000100110000110000000000
00000000101000001000000000100110000010100011000000101000010110010100000100011010010000001101110010000
