00000000001011010010
00100001101100000000
10000000000111010000
01100001100010011110
10000110000011001110
00001101010000010000
**000010100000100000
1**00000000100010000
01*10010100100000001
01*00101000001100000
00*00011000000011100
00**0100000010010001
011*1010010010100110
01010100100000100100
01111001111001000100
10100110000000100000
00100010010010000010
00111000110011000100
01011011000000010101
01011000101001000000

Start cell: 6, 0
Goal cell: 13, 12