10001010001000000100000001001100000000011000100101000001100000100101001000000100000000110100000000000
01000000000001010000100100000101100000001010101001010111010000100001000001000010010001000011000000111
11100010001000000100100011000000001010000000100000010000000001100100011101100000000001010110001011100
01001010001000000110001100000010101110000001100001010100000110000110000001100001111110100001100000011
00000000000011100001000000000110111101101110000000000011100000010010010000001101001000101000000000011
00100010010000001000101000010000011000011011000110000000100000000001001110000000000000100010001011010
01111010001000000100010010110100100000010010111111000000001000001000100100011100001011001111001010000
10010001101000000010000000001011001100000011010010110110011000101000110000000100100000100101000000000
00011100100000001000010110000110010101101010000010001000010110000001010011011100000100010011101100001
01100011010010000000010001000110000011000100000100000001110101000000110100010000001100011000010000010
01000111000000011010010000001100010001010111000110000000010000010000010100010000100001000001010101001
00001000100000011000100001111000000001010111100100101001111100000101000100100010111010101000010000011
10101001000000000000100101000001000001010010010000111100001010010000000000011100010101000000000000000
01010000001010010100101100001010010000000001001000000100000000010000100010000101000000000000010011100
01100110000000000100011100100000110010110100100000000000000000000000001001000011101000100000010011000
10011010000001101000000100010000010100010000000001000101001000000010100000001000000101010100000001100
00000000101011000001010000011011110010000000000110001001100000000100000011000001001001100001000101001
00101000011011001111010000000000100010010000000001110110110000001101011010000100110001110101011001010
01000001110001110100011010100000000010010011101010010000100000011110101000010001001010100001111010010
00100100000000000010010101011010001000000001101111100110000101101001000000100000000011100100001100010
00101010100001000000000101010110111001000010000001100110011000110100100000100000001000010101000111010
11000100000111000010000011100100000100100001000000101110011101001000001010000100010001110000001001010
00000010001000000000000110001100100000010100001000100011001100000001100000010010100000100000100001000
10100100000000011001001001001010101100010011110010100110100001001000011000000000000000011011101101111
00101000101100111000101101100000100010000000000000111001000010010000100000000000001010001000001011000
00010011010100011000000100000011000000001000100000111010000010011000000010000010000011010001101100000
10011010101100001000100001101110000110000000010101110000011001100000001010101000010000110000001000100
10000100000001011101011000001000010000010000000101111000000000110100100000100110100100110101010000100
11001000010000100000011000001101101000001011010000101000011000000100000010001100011100111010000101001
01100000010000000100011100001000000001000010110101010011110110011000011000101110010010000000111001100
00010100000100110000000011000000000001100100000010011101111001011010100000000001000000000110001101001
10010010000000011110000100001011010101011010000100001111011000010100010110001000110000100000000000000
00110000000001000001000100100001011010101000101001010100000001000111011000011000000000010010010000010
00001110001110100100000001000101000100001000010000100011001001010000000010000100101000001110001010000
00000000000000011001000000000000000000000000111001001100101001001000100111000101000001000000000010110
10100101000000101001100010001000000010000000101100110000000000010000001000100100010010001001010001100
10011000100010010001000000001000111110010000001101001000010000101011001100000101110001010001100110100
00000100010001000000001010000011010000000011000000100000010000100111100000000110000000001010100000010
00000100001000000110000010000101000000000000100000000001100110000010010010000010010000101001010001100
10110000000000000000000000010101001000100111000001110001110000101101000100000100110000001000000000000
00010110010100001100001101000100001010100010101100000110000000010100011001100001101000000000100001111
11000000101000000000000000011000000010100000100000000000000100011001000001001000011000001100000001011
00000101000010001001010100010100000010100100100000100000001010110011000010011000001000111000010101000
00100101000000000100100100001000000001000000000001010101000100001100000001011011101000000010001100010
01001001000000001001010100010100010110000011110011001100001000100000001000010001010100001000010001100
10110010010100001010000010001001000000100001100000000010000010010001010011111100000000000000001000001
10010000101010101001010010010010000011000000000001001000001111110000010000100101100001001010000111001
00101000101100000010001000000000010000100000000000001000010001000000001001000000000100100100101000010
00010000010101100011101110110001000001111101000001010001000111000001000011011011011001000000000001001
00000010010010001100001101101110001100101001100000101010001011101101000000001001001100000110100100001
10011000100000010000001101110011101000001010000110000000010001000100010001000001101101010001110000100
01010100000010000001100000000010010010111011000100000001000000010000111010010110000000100001001000001
10000100000001000111000000101101010000010100000101001000111010110000100000100000111011011000000110101
00111000011011100001100001110000000100100100001010100010000101101111010110000010000101100010010100001
01010000000010100000001000000001010100001000000110000011010101101100001100000011010001011000000000100
11110111111000001000010101000001100000000000000000100100100011011000011110001000100010111000001000011
01011001010111000000100100000100000000010000000010011001001001001000011010000001010000001000000000011
00001000000001010001011000001011000001000010101000011100010110000000010000001001100111010000000010000
01000101000000010001000000000101001000000010100001001000000000100001101110000100010000010001100010100
00110000010010000001010000001001101100011001001000011000000000110011101000010010011000001000010000000
00110110000000000000100001010100000010000100001011110100000000010000000101000001001001001001000001000
00011100000010000001110000000100011000101110100000100010000000000000010100000000001001011110000101000
00000001010100001010101000000101111011001001010010110010100111100000101010010100101000010001101001001
01001001001010010000000010000000101001000000001001000101000000001011000000100110101000111000001101000
00100000011000010111001100000001100101000100101000000100000000100000110100100010100000000000110000000
01010001000010000101010000000000000000010100010001000000001000001001100010011010001000001101000100001
10001100100001000110110000010100001010110000001101000001111100000111010000000101110000110001100000000
01100010001101010111111000100100000000011010000000000000111101000000000000001001010111110111100000010
01000110000101010000000000111000100001000100001001011000100000000100000100000000000010100000011101000
10010111000100110100000000000010000000010001001111101000010000010000000110100000000100010000100011000
00000001000101010100000111001000000000110000010000001100000000001111100000010101000100000010000011000
10010001000001011011010101011100001000100000001000100000000011000101101001100001110000000000100000001
00100000000101010110010000100001010100010000101100000001101010000100000000001110000100010001000011100
00001010011000001000000000101001000100000000001001011000011100000001110010000000010000100000000001100
01001001000100010000010000000000100000110000000010000000010011000101110101010010000000100111000011100
00011100001100000011000001110001000001001010100010010001000100000000000000100010000001101000100111110
10000000001101000001011000100001010100011010000000100001001000000000000011000001101011010000000000010
00000000000010001001100100000110001000100100010000000000001110001001000110100100100000001010000011010
01000000000001000000000000000110110000001000101000111001110000100001011101000000001010001001100001100
00101000100001110011010010100000000110000100000000010000001000000111110000001100000000100000101000001
00000110001011000000011100001000101000110001000000111010101100010110001011100010000000001001000001110
00101000000000000000110011001100100001010110010000100011001000001100101000010000010000000010010000000
01001100110010001110001110110010000101010100000001000010110100010010000000111001110010100000100010010
00100010000011000001000001000010010000011010000101001010011001100011111010010000000010000000000100000
01000001101000011001100101100000000000100000110101000010001011000000111110010000100100001011001000000
01000010001110000100100100010000110110001000000001000000010000101010100000000100011100100100000100001
00000100000100101000001010001000001110000010001000100000111010001000000000110010001010000100000000110
00100000000000010100100010100010100110000100000000000010000000000010100000110010010000100001100000101
00001100001001011000101000011000101010000101110100000010010010010000110110110100100000011011111100001
11000000100000000100011100000111100001001110100011100100000110010000000101000001010001010110001100000
00000001000001101100110001001101001000000110000001100000010000100010001100010000010000010000101010100
01000110000100100010010000100101010001000000101001000000001000000110000001011000000000000000000100000
00000010000010001110000001011100010001100000000000010110000000001001110100000100011010000000010111000
10000000000100010010010101000001001000000100011001110010101000101001100000000000101110010000100100000
00001010000001110000001000011100000011000110101010100000010000000000110001001000001111000011100011100
10000000010001000010110100010101000010001000000101001001011000010000000000010101011000001000010000000
00001000100110100000000100000000011011110011010000000100001000000000001011000011100000001110000011000
01000010000111000101011001110010001001001100010001111000000000010100000000111000001000010000010000011
00000000110101010000100100000110110001100000010010011011100100101101100000000100110000000010000100010
00101111011110010001011100101010100000100000100001010000000000100011000010000001100101011000000000000
00000000010001000010000000001000010000100000000000110110000100100111000100001000000111000110010000100
