00001000000000010001
10000101010010010001
00100001100000110001
00001000100100110000
00000011001000010101
00010000000001110110
01000110110100000001
00100010101011100100
00001110100000010000
00000000100100111100
00010001011001010000
11110010011101010011
10000000011010000000
00100110010001001111
00010001001010101010
00011101001011010000
11000100000111000000
00100011101101100011
00000001100001100100
00000000000110010011


Start cell: 16, 6
Goal cell: 8, 0

Failed