00000000010110000000000000001110000111001011000100011000100010000011000010000010000101001010000001010
01000100100011011000000011000000100100001010100000101100100000100100000010110000010111100001000000000
11000001001011000110000011000110011100011000000000101000100000001000010001000110100010001101011010101
00001010000010000011000000110000100000000110110101000010100111000001101000000000100001000100010000000
11100110000101000000000011000000000101011001001100110100010000001000001000110000000101000000010100000
10001001010000000000000111011100000001111100000100100000000001000000011001000101000001001000000000000
00110010010000000010001010101101111010000010001000100010101111100000101000010001000000000010010000000
01100100100101000000000000000111000100000100011000010001000001000000000101000001100110101110010001101
01110001100101000000111000100010111001010100001110000001101111000111001000010110010101000000100000000
00101000010000100000100010000100001000100001010000001100010001010000010000010000000100011100010000000
00110000000000001000101000000100001011100000010010100000100001010001010000100000110000000010100011000
00100010000000000011000001001010010101001010110010010000100000010000100000000001011100010000001000010
01110010000000100000000100001000100110000000001101100111011010001000000001001100100010101010011100000
01000010000000110001001110100110000000000010110100000010010010001001000001000000000011001000001110100
10110100010001100001100100100001010000100001001010000100011101010000000100110000001101001100110000001
10011000101011000101001101101001110100100001100000000011000100110101101000011000000001000000000000000
10000100010000100110001010100000000000000101010010000110000010000010011011000000100111000001000000110
00000000100101000000000110000001000000001000000001100000000101010100101010101000101000010110000010011
01000100001100101000101000010001001111100000000001000001000100100000000010100001100000001000000000000
00100000100000010000000010111100000001010011000100010010101000100000010000110110011001001001101010100
01000100001001100010000100000100111110000010000000010010110000000001011101100100100000001000000000111
10100000000001000000000000100010000001000100000110000000100000000100000001001001101101010100101000010
11100000001010100000011010010100101000100000010010100100100101000000101000000001001000001000100001010
01000111011100001000001000100101100100110011100000001001000100000010011010011100001111010010000000000
11010010010001010011000100001000101010000100010111010010000000100000100111001010010011010011000000011
00110100100100000000000000001001101010000010000100000000110000010000011001100010001000010000111100010
00001010010001000001000000010100011001000100001001000000101001001000000000100001110010101011000010000
10000110000011000001010100000010001010001001000110101001010000100000000110011010100100100110100000110
11000000000011000101100000110000000010101000011000000000011100001000100001000010000000100101100010010
00010001001010001001010101110110000001010011000010111010100010000100010101000001011000000100000000100
10100001000000001001100100001001001000101001100000000011011001000010100001011011100000010010100110001
00100000111011010100000000110010110000010000001001100010011100101000001010100001110100010101100001110
10000100001011000101000000011001010001010000100010000001100110110000011111000010011000011001000010010
00110000111010010000000000000000110010011100101001001000100100000000000010000001100100100010000000000
00101000000001101010011001000010010110000010001110000100111100010000000001100000100001010010000100001
00001101000001100000100001000000000000000011010100010000000100000000000001000110100000001110000000000
11011100100010010101111000111000000001001011001100101110000010100110001010010010001010000100011011001
00001001011000110000000000000000000001010000110100000000001000000001001000000000000000000011111100101
00010000010000001100001000000000010100110000010111110011000010000010100001001001100001110001101100010
00100000100000000011000000000001000000010100001110000100000101010111000001110100000000000000110000000
01001000000011000001000110001000101000100100100010000000000100000000101000100100100011000010100000010
00110001111010000101110010110010101100000000001100001010001001000100000011000000011000010000100000101
10000010010000011100000000110011000100001100010001100001100100100000100000011101100001100100100010000
11001001000000010011000001000010100100101000110000100000000110000001111111010100111000100110000000010
11100100100010000010101000000000000010100001001000000100000010110010000011001110000100001000100100101
01010101110000110000100100011000000001000000110000010001100001110001001000100000000110000010000100010
01000000000101000000100000000000000000100010010010000000000000010110000011000001101000000000001000001
00100101001110000000010101000001000001111001000010001110010000000000011000011000100011000001000010010
00000000011111100101101100010001000001011111000000010000110000101100001011100100110000100100001101001
00101000000110001001101101010010111100000011001100001101001000001000101101000000000010011101000011001
10001000100000010001010000100001100001110111000011000000011100010001010000010000100101001011000000011
00000010000100000110000111000000001011011000100110100000001010001000001000010100100000000100011001000
11000101010100101110000000000101000001011001010001001111000000110000010000000000000000000100000101001
00001000100100100000001000000010110100001100001110110000100100100000000011110110100101100010100000001
00000001000101000010000011010010000000110100100001110000010000001010010000000010101001010010000000010
10110000100001000001100000110010110101100100100001000110000100001110110110100011010111010100101001100
00000001000010000000000000110100100110010110010101010001110011011100000110101011000000101110000010110
10001000000100100000000000000000000100010010010111001000000001011101000000100011000100000000101100001
00000001100000000000101110000100001010111010010101100010100000000000001000000101001111000001000011010
01100001000000000111010001110000001010100100000010010011000000010000100111000000100010101000110000101
00010100010100001000000001000000000010100010111111110010011100101110110100011110010001101010010010011
00000000110001100110100001000000011000100101100101000000010000000000000000000011000101001000000010010
00001100000001100001000010110000000100111100001000001001000000001100000000101000110011000101100000000
00110000001110000011000000001100000100000000000000000101000010000100000001000001000100100000000110011
00001000000101001100010000111100100010000011011110000000001001001001000001000000100011100001011101001
01011110010100100010001000000010110000011000000001111001001010001011000001011001000100000110100000100
00111000100000001000000000010000100010010100101000000001111111000011110011101010101100100000100000000
00100010000010000010011000000000000000000111100001110100000110110000011001100001000000001000000011000
00000010001010110000000001010001000000001010010001010000000110000011010001000111000000010000110000000
10010000100000110000011000000000001100110100110000010001101000100100001100100100010001100000100000101
00110010000011101001101000101001000001001000000001100100100010000000001000000101100001000001001011000
11001000010000000011100001110001101001000100011110001001010101001100001011110000100100111001100001000
10100000101001100100110001100100100000000110110010010000001000000100100001010000000000000101100100010
10100110000000000100000000000001000100100101000100000000000010000011100101011000000000000000100000111
10001010001100000000100100000100010100001000010100000100000000010000001001010111000001011001101001010
00100000000010010001011000010001001000110000000000011101000100000000101010100000111001000000100000010
00000011110101100101110000010010001010100000000001000010100011010011000010010010000111001111000010100
01001010001101000100010010001001000000010001000010010000001100000011111101000100110111000011100000100
00001000011010000010001001101010001000001000010010000100010000000100010110010011110011001011101000011
11000000010100001001010100111000000000000100000000000100001001110000001011100010000101010110000001000
10000010001101101000011100110010000101001110010111100010101000000001110000100110000011010100000010011
01001000000101000010101010000000000000101111100010111000011000001100000101000011000101000000010001000
01100100010000000000101010000010111000001000001100011010000110001100000010001100000100011100000001010
01000000001010000011000101000000000010000100001100101011100100010000010101000111000000000000000111010
00000100000000100100000001100010010001100100001011000000010100010101000100001100100001001000000000110
00010010000000100100001000001000000010100000010011011001000110001000000000000011000010000000011000000
00000100110001000001000000001001000100001010100000100010011000010000101010100000000011100001000000011
00010110001100011000000010111000001000010110001100010000000000001011010000100010101100100010000001001
10010010100011011100000000000100101100001110001000010000010000000000111111000101010000001000001000001
00100101001000100000000000100100010001100101010000100001010111010000010111000000010001000000001100011
00001000000001000000111101010000100000001000010011001100110000000100100110001000111000101100011000001
00000010101000100000100000001000000010100110110000000100000100010000111111100100000001101101100100011
01110000010001000011001010000010001010110000010001010000010011000010011000000000001010110101100001001
10001111001011000000001110110110001100000011100000000001101100100000001001000011110110101101000100100
00110100000001000101001100010000010000101001100100001001110000000010000000000011010001100100101010000
10100000101101010111100100100010001010100100100000001100100001010001001100000010001100100100001000001
00010011011101101011000100001100010011011000001001110100000001000000100000001000001000011000000111100
00010000000000001100100110010101101000000001000010100101010100110000001110000000011000000100010000000
10101101011000111001110100000101001010001000000111100110010000000000001010100011010110010000001000100
01001000001000010010001000010100001100000010011101001011011010100101000010001000100110000000100100110
01101000000100001010100010100000100100000010100000001010000000000111110100001010000010010100010101001
