00100011000000000110001101001100000000000000001100010100100011010101100000000001110000100100001011001
00000100000100011010000101011100100000001010000011000010000011000000000000000100001001000000100110000
00000001000001010101100010101111000000000000000010010001000000100000010101011100100000111000000010000
01100000001011001010010001000100000000000010101001100010000000100000000101001010100000000100011010111
00000000000111000001100011010001101010010001010000010100101001100100001000100100100001000011000100000
00000010111000011000000001110100110001010001001001000000001000011100000000000010000100010000001000000
10001110000110001101000000000000011000001000000100101100001000100110001100001000001111010010000110000
00000000000000011010010010001001111000000011001010110000000000001001000000100000001100000000000000000
11000000001100000110000111000000100000010010000000101010000110010000100010010000000000010100011101001
01100101000010001000011001000100100101011100000110100010010011000000000011001000001110000000010100010
10011000010001001010001001010001100001000000101001100000100111001000010110001000100000100100000100000
10000010100001000010000001110000100011100001100000000001110011110100101000111001000011100101000110100
00101100010000000000011101010101101010001100001010001010100001001000000011000001000100000000000000001
10000100000000110110110000000100010011001000000000000101101100010010110100000101110000101100001000000
01001000001100010101011001001100000000000011001000001000101000011010000111000000000000000000000001110
10100000000000010010000000000100100000000000000000001111000000010011100001110100000000000100110000001
01000000010110010111100001000100100101100100110101000010000000000010000011010100011100000001000000011
00100000100011000000000010100100000110010000000101000100100100011010111010000000010000000000000010000
00011111001100000000000010011110001000000000010010000000101100000100010001000001010111100000101001101
10110000000000011010101011000000010001000110000010001000000001100001001010011000000010001100010000100
10000000010010111001100000010100010101110001000000001000010010000000001100011001111000111000101011000
00010000000010100000010100000000010111110011101010110001000000010000010000101000100001000000001000000
01001111000010000011000010000100000100100010110000110101000001100100000011100000000000000010001101100
10000101000011000000010000100000101000000000101001000000110000100000111001110000100000001101000100001
10001000111001000101000000010100010001000110110000001000010010000000110000100010000000101001110000010
01000101001011010000001010101110000010010000000010110010101010010010111000001000010000000110000000010
00111000000010000000000011000010101010011000000001000010101110110000001010000000110100100001010100100
10001000001010010100010101010101100010100101000000100000110010011100000000011101101000110100001001100
00000001001001000100000010010101000110100011010000000000011011001010010000000000000001001011000000000
10001000101011011010001110101000010010011000100000110000000001000000000001001100000010010010100010000
01000000000000000001000011100010001110000001000000011100000010110000001100001100001000110011000010010
00000001000001101101000100011101100100100011110001010000001000000001100010010000100000000110001100000
01000010110000010000000001010110100100001100000000000100000001110111001011100101000100110001000101000
00100101011100001111000101010101101000000101000010001110010000010100000100001100000001000101100101011
00010000010001100000100000100000100000101001000000000011000100000000010010110001011100001000011110000
01000000001111000000001100000110001001000011000000101010001000000101101111110100000000011000011011000
01010010110000000011100000000000000010111111000000010001000000010010000001100000001001001010000010000
10000011010101001100100000001101000000000100001111100001000000000110000111100010000000001011001000000
00000110000000001011011100101011010100000110001001010101010000001000010000001000111001001000000000000
00000010011000010010000010000000110010100111000111000011000001100000000001010101101110000101000000000
01010000001000010010100000010010000100100110000100010001001010001001000110111010100000001000011000111
10000011001100000011110001011000000110110001100100001100011100000100001111101110100000010011101010000
01000000000001001100011000000001100101011001000000101000000000111100000101010110100001000000001010000
00011000010000100000111100001001100110000000110001100010001101001001100010001000100000011001001101111
00101100000000010010000010010001000100000000000000001000000000001000110000000000101010000100110010000
00001010010000001010000010000000000000000000000000101000000010001001000010010100001100100100010010000
00110010011011011000011001001010010001100000000000000100100000101011101011001100110000000100010011011
10001000000010100011000000000111001100010100000000000001100000011001000100000101100001010000011110000
00000000100110001111000110000010111001111110101110000001100000100000000100010000011100000001100010001
00101001000100000110001010000001010010010000100101000010000010011000100010100000010000001000000000100
01001001100010000000100101100100100000100100000001000011000100000101011000001001010000100100000001000
01000100000000010100110000110010010001011001000110110100000000000001011001000000110010000010001100101
00000101000001001000010100010101101011000101000000100010000011000010110000100001010101101000100000001
01011110001100001100111000110110000000000000011000100100101110111001001100011111000100000100001100000
10000001111100010101100011100000111101010000000110110000101000011010110101100101000101001001101000010
00000111000010001001000110011000101000000000100100000101101000000000000000001010101110111000010000100
10000111100010110100000110100000100100000011010010000000000100000001011110000101000001000010000101110
01001000010110011001011111100000010011101000101001101010100111001001000001100001110000010001010000000
01000000001000001100000010010001101001000110000101000101010100000010100100010010101001110000011101000
10100010001000110000000010011000100000100100101010100100110001000011010110100001011000110000011000001
00000111001000000000110000101001101110000000101010101010001000000010000010000011101000110010110011001
10001001000011010001111100011000000100111101000000101100001100010000100110110101010100000000100100001
10001100010010010100110100001000001000000110001000111010111000000001110000100011011110110000100100101
00100100011000110010001000001111000001000000111100001001100001000110000001000111000110100000001101000
11010100101000100101001000000000111000001010110010100000010011010001100001000001000010001011000100110
00100000010111110101010000000100110010010000000000000100110100000111100001000000001011101000111000000
00100010100100001011000111000010011010000101011101010000011001110011011000000011010000010100100010010
01001000000100100111010001001110010000100001000001001010100001100100011100001110100010000011001100000
10000001001000000010010100011101001000000100001001001100001001000100000111100001010010110110011110111
00000111010101100100001010001000001000011100001000100001110100100000010001000000010000000000000011000
10010000000001000100000000001000000010100000000100000100010000100010100110110000100000100100100000000
10000000010100011100100001100011000001011010100000011000011110100010010000100111001101100010011010001
00001011000001011000001100000010100100011000010011111000010011101001100100011000001000100001011000001
01011000010010000010001010100110000000000000000000101000000100000010010010000011000100100000000000000
00001000100000001010010010010000010000010000001100011001000110101000001001100011001010110100000000100
01011100000001100011000000000000011000100000010001100000101101000110011000010000010110110100100001101
00001000000110000001001001010100010000000011000100000100000010100000010000010100001001000010000100000
00010100010110101000010100000101010010000000100001000100000101100000000100010000101010001001000000100
00011000000000000110010010000001001001000000101001000000000000101001100000101000000000000100001100000
00000000100010101101000001000100000011011110011000000000000000100010000110101011000001100100001011001
10101011101010000000100100001010100010000001000000100010001101011100000010100001101001000110100100101
00111000000110000101000010100000011010010100000101010000001000001000000000011100101000101000000000101
01011000001000000010011010001001100100010000111111100100110000000011100000010001001000010110111100110
01000100011111111010100000001111100101100000000101000001001000000100000001010000011000100111000000001
10000101000111010100101000111000100110100000000100000000010000010000010100001110111001101001010000100
01010000000101001000100000110110001110000100110010000000010000010000100100110001001101101000100001011
00100000100000010000101001011111001000000100100000100000101010011000111110100111100001100011010110100
01000111010111010001001101100001100100011000100000100100000011000101010100000101101110000100000011000
10001001000010001000001000000101011001010000001001011100100001000000010000100000100000100100010001100
00000000010110001000101000100100100010000101011010101100110010010000010110001011101000000110011100001
11000001100000000010010110000101000001100001101000100000000011001000111000100010100100000101101001000
00010010100010100101100000000100000100011100110011001100011011001001000101100100110000110011100000010
01000010001000010101010001000000100101110000000000100001001100000000101000110110001000011000000111001
10100000010010001000000100110000101010000000101010000001010000011000010000001010010100101100000001010
11100011000110000011000110010100001000000010010010000000001100011000100001000001000000000010000110101
00000000010101001101111001101100000000101001111000000100111001010100010010010100000100000100000010001
11101000100000000100001010010010001000000000101001110000111010101000010111000000000000101001010010001
01001111000100011000010000000000100000000010000000010010010000010010101010000011110000000100010010110
00001100001100011101000011001010000000010101100000011011010000010001110000000100000010000000000000010
01001100000100010110111011000000100111001000100011110110000101000100001101000000001000000100011101010
11000001001010000000010000000000110101010010000001000010100100010010001000010001000000011011111001000
